....................
....................
....................
....C...............
...###..............
....................
....................
............C.......
...........###......
......CCC...........
......###.......CCC.
................###.
.###................
....................
####################
